0000000000000000000000000000000
0000000000000000000000000000000
0001100000000000000000000000000
0010010000000000000000000000000
0001100000000000000000000000000
0000000000000000000000000000000
0000000101000000000000000000000
0000000100000000000000000000000
0000000101001001000000000000000
0000000000100000000000000000000
0000000000010110100000000000000
0000000000001110100000000000000
0000000000010000100101100000000
0000000010001100010111100000000
0000000011001001011000010000100
0000000010000000011000010011100
0000000000000110001100010011000
0001100000000000000000000000000
0010010000000000000000000000000
0001100000000000000000000000000
0000000000000000000000000000000
